83,83,40,41,42,83,83,83,83,83,83,83,83,83,83,83
83,83,40,41,42,83,83,83,83,83,83,83,83,83,83,83
83,83,40,41,42,83,83,83,83,83,83,83,83,83,83,83
83,83,40,41,42,83,83,83,83,83,83,83,83,83,83,83
83,83,40,41,42,83,83,83,83,83,83,83,83,83,83,83
83,83,40,41,42,31,31,31,31,31,31,32,83,83,83,83
83,83,40,41,41,41,41,41,41,41,41,42,83,83,83,83
83,83,50,51,51,51,51,51,51,51,41,42,83,83,83,83
83,83,83,83,83,83,83,83,83,40,41,42,83,83,85,85
83,83,83,83,83,83,83,83,85,40,41,42,85,85,85,85
83,83,83,83,85,85,85,85,86,46,47,48,85,85,64,64
83,83,85,85,85,86,86,86,86,46,47,48,64,64,64,86
85,85,85,86,86,86,86,86,86,46,47,48,64,86,86,86
85,86,86,86,86,86,86,86,86,46,47,48,86,86,71,71
86,86,86,86,86,86,86,86,86,46,47,48,71,71,71,86
86,86,86,86,86,86,86,86,86,46,47,48,86,86,86,86

00,00,00,11,00,00,00,00,00,00,00,00,00,00,00,00
00,00,00,11,00,00,00,00,00,00,00,00,00,00,00,00
00,00,00,11,00,00,00,00,00,00,00,00,00,00,00,00
00,00,00,11,00,00,00,00,00,00,00,00,00,00,00,00
00,00,00,11,00,00,00,00,00,00,00,00,00,00,00,00
00,00,00,11,00,00,00,00,00,00,00,00,00,00,00,00
00,00,00,11,00,00,00,00,00,00,00,00,00,00,00,00
00,00,00,22,22,22,22,22,22,22,11,00,00,00,00,00
00,00,00,00,00,00,00,00,00,00,11,00,00,00,00,00
00,00,00,00,00,00,00,00,00,00,11,00,00,00,00,00
00,00,00,00,00,00,00,00,00,00,11,00,00,00,00,00
00,00,00,00,00,00,00,00,00,00,11,00,00,00,00,00
00,00,00,00,00,00,00,00,00,00,11,00,00,00,00,00
00,00,00,00,00,00,00,00,00,00,11,00,00,00,00,00
00,00,00,00,00,00,00,00,00,00,11,00,00,00,00,00
00,00,00,00,00,00,00,00,00,00,11,00,00,00,00,00
00,00,00,00,00,00,00,00,00,00,11,00,00,00,00,00
